10 10
start=0,3 end=9,3
0 0 0 1 0 0 0 0 0 0 | 0 0 0 4 0 0 0 0 0 0
0 0 0 1 1 0 0 0 0 0 | 0 0 0 7 12 0 0 0 0 0
0 0 0 1 1 0 0 1 1 0 | 0 0 0 1 5 0 0 6 8 0
0 0 0 0 1 0 1 1 0 0 | 0 0 0 0 5 0 4 1 0 0
0 1 1 1 1 1 1 0 0 0 | 0 6 12 4 5 6 13 0 0 0
0 1 1 1 1 1 1 0 0 0 | 0 1 1 1 7 9 5 0 0 0
0 0 0 0 1 0 1 1 0 0 | 0 0 0 0 5 0 1 4 0 0
0 0 0 1 1 0 0 1 1 0 | 0 0 0 4 5 0 0 3 8 0
0 0 0 1 1 0 0 0 0 0 | 0 0 0 7 9 0 0 0 0 0
0 0 0 1 0 0 0 0 0 0 | 0 0 0 1 0 0 0 0 0 0
